00000000000000000000
11100000000011111111
00110000000011111111
00010000000011000000
00010000000011000000
00010000000011000000
00011001111111110000
01111111111011000000
01011111111111000000
11000000000000000000
00000000000000000000
